el ojo	eye
la nariz	nose
la boca	mouth
la garganta	throat
el cuello	neck
el estómago	stomach
el dedo	finger
el dedo del pie	toe
la oreja	ear
el brazo	arm
la pierna	leg
el hueso	bone
el cuerpo	body
el pecho	chest
el codo	elbow
el corazón	heart
el musculo	muscle
el cerebro	brain
los hombros	shoulders
el tobillo	ankle
la rodilla	knee
la cabeza	head
el pie	foot
el oído	inner ear (hearing)