acostumbrarse (a)	to get used to; to grow accustomed (to)
apagar	to turn off
arreglarse	to get ready
averiguar	to find out; to check
barrer	to sweep
calentar (ie)	to warm up
cocinar	to cook
comprar	to buy
cortar el césped	to mow the lawn
deber	should, must
devolver (ue)	to return (items)
encender (ie)	to turn on
hacer mandados	to run errands
ir de compras	to go shopping
lavar	to wash
limpiar	to clean
pasar la aspiradora	to vacuum
poner/quitar la mesa	to set/clear the table
poner gasolina al carro	to put gas in the car
preparar	to prepare, to make
quitar el polvo	to dust
seleccionar	to select; to pick out
soler (ue)	to be in the habit of; to be used to
tener que (infinitive)	to have (to do something)
la agenda	datebook, planner
la cocina	kitchen
una cita	an appointment; a date
el centro comercial	mall
la costumbre	custom; habit
el dinero en efectivo	cash
el dormitorio	bedroom
el hogar	home
el horario	schedule
la limpieza	cleaning
los muebles	furniture
los quehaceres	chores
la rutina	routine
la sala	living room
la soledad	solitude; loneliness
el supermercado	supermarket
la tarjeta de crédito/débito	credit/debit card
auténtico/a	real; genuine
atrasado/a	late, behind
barato/a	cheap; inexpensive
caro/a	expensive
cotidiano/a	everyday
diario/a	daily
inesperado/a	unexpected
previsto/a	planned
a menudo	frequently; often
a propósito	on purpose
a tiempo	on time
a veces	sometimes
apenas	hardly; barely
así	like this
bastante	quite; enough
casi	almost
casi nunca	rarely
de repente	suddenly
de vez en cuando	now and then; once in a while
en aquel entonces	at that time
enseguida	right away
por casualidad	by chance