a causa de	on account of, because of
a mi parecer	in my opinion
a pesar de todo	in spite of everything
actualmente	at present
ahora mismo	right now
al considerar	upon considering
claro	of course
como	since
de ninguna manera	by no means
de todos modos	at any rate
en cuanto a	regarding, with respect to
en la actualidad	currently
en realidad	actually
en vista de que	considering that
es cierto que	it is true that, it is certain that
es seguro que	it is certain that
hace poco	a short while ago
hasta el momento, hasta la fecha	until now
hay que tomar en cuenta que	one must realize that
hoy d√≠a	nowadays
la verdad es que	the truth is that
lo esencial es que	what is essential is that
lo importante es que	what is important is that
lo que importa es que	what matters is that
sin duda	without a doubt
sobre todo	above all