aconsejar	to advise
desear	to desire; to wish
es importante	it's important
es necesario	it's necessary
es urgente	it's urgent
exigir	to demand
gustar	to like
hacer	to make
importar	to be important
insistir en	to insist (on)
mandar	to order
necesitar	to need
oponerse a	to oppose
pedir	to ask for; to request
preferir	to prefer
prohibir	to prohibit
proponer	to propose
querer	to want; to wish
recomendar	to recommend
rogar	to beg
sugerir	to suggest