la cinta	film, strip of film; tape
la luz	light
alargar	to drag out
enterarse	to find out
entretenerse	to be held up
respirar	to breathe
pesado/a	annoying
precioso/a	lovely
turbio/a	murky
a lo mejor	maybe
acariciar	to caress
llorar	to cry
la obra maestra	masterpiece
lucir	to shine
el cuadro/la pintura	picture, painting
arduo/a	difficult
el cansancio	exhaustion
acaso	perhaps
el retrato	portrait
pintar	to paint
retratar	to portray
fatigado/a	fatigued
imprevisto/a	unexpected
previsto/a	planned
el pintor, la pintora	painter, artist