AH	A
BEH	B
SEH	C
THEH	D
EH	E
EH-FEH	F
HEH	G
AH-CHEH	H
EE	I
HO-TAH	J
KAH	K
ELLE-EH	L
EH-MEH	M
EH-NEH	N
EH-NEE-EH	Ã‘
OH	O
PEH	P
QOO	Q
EH-REH	R
ESSEH	S
TEH	T
OO	U
OO-BEH	V
THOH-BLEH-OO	W
EH-KEYS	X
EE-GREE-EGG-AH	Y
SEH-TAH	Z