malo	bad
grande	big
rubio	blonde
moreno	brunette
fácil	easy
gordo	fat
bueno	good
guapo	good-looking
difícil	hard
trabajador	hard-working
importante	important
inteligente	intelligent
interesante	interesting
mucho	much
simpático	nice
viejo	old
bonito	pretty
pelirrojo	red-haired
mismo	same
bajo	short
tonto	silly
pequeño	small
alto	tall
delgado	thin
feo	ugly
antipático	unpleasant
joven	young