¿Prefieres?	do you prefer?
Prefiero	I prefer
Hay que	one must/It's necessary to
Debes	you should
Debo	I should
Debemos	we should
Necesito	I need
Necesitas	you need to
Necesitamos	we need
Tengo que	I have to
Tienes que	you have to
¿Tienes que?	Do you have to?
Quiero	I want
Quieres	you want
¿Quieres?	Do you want?
Quieren	they want
queremos	we want
Me interesa	I'm interested in
Me fascina	I'm fascinated by
Me encantaría	I would love to
Me gustaría	I would like